%%%%%%%%%%%%%%%
%  GGG        %
%             %
%             %
%      G      %
%             %
%             %
%      P      %
%             %
%%%%%%%%%%%%%%%
% % % % %%%%%%%
%%%%%%%%%%%%%%%