%%%%%%%%%%%%%%
%P          G%
%  %.........%
%     %      %
%       %    %
%........G%  %
%       %    %
%     %      %
%   %.......G%
%%%%%%%%%%%%%%
% % % % %%%%%%
%%%%%%%%%%%%%%%%%%%%%%%%%%%